6 5
3 3 2 1 h
1 2 2 1 h
4 2 1 2 v
1 4 1 2 v
1 5 2 1 h
2 6 1 2 v
4 6 1 2 v