12 8
7 1 2 1 h
4 3 3 1 h
5 3 1 4 v
2 6 1 4 v
6 4 4 1 h
7 4 1 2 v
2 8 1 3 v
5 8 2 1 h
1 6 4 1 h
1 10 1 5 v